/admin/	django.contrib.admin.sites.index	admin:index
/admin/<app_label>/	django.contrib.admin.sites.app_index	admin:app_list
/admin/<url>	django.contrib.admin.sites.catch_all_view
/admin/autocomplete/	django.contrib.admin.sites.autocomplete_view	admin:autocomplete
/admin/jsi18n/	django.contrib.admin.sites.i18n_javascript	admin:jsi18n
/admin/login/	django.contrib.admin.sites.login	admin:login
/admin/logout/	django.contrib.admin.sites.logout	admin:logout
/admin/password_change/	django.contrib.admin.sites.password_change	admin:password_change
/admin/password_change/done/	django.contrib.admin.sites.password_change_done	admin:password_change_done
/admin/quiz_app/answer/	django.contrib.admin.options.changelist_view	admin:quiz_app_answer_changelist
/admin/quiz_app/answer/<path:object_id>/	django.views.generic.base.RedirectView
/admin/quiz_app/answer/<path:object_id>/change/	django.contrib.admin.options.change_view	admin:quiz_app_answer_change
/admin/quiz_app/answer/<path:object_id>/delete/	django.contrib.admin.options.delete_view	admin:quiz_app_answer_delete
/admin/quiz_app/answer/<path:object_id>/history/	django.contrib.admin.options.history_view	admin:quiz_app_answer_history
/admin/quiz_app/answer/add/	django.contrib.admin.options.add_view	admin:quiz_app_answer_add
/admin/quiz_app/question/	django.contrib.admin.options.changelist_view	admin:quiz_app_question_changelist
/admin/quiz_app/question/<path:object_id>/	django.views.generic.base.RedirectView
/admin/quiz_app/question/<path:object_id>/change/	django.contrib.admin.options.change_view	admin:quiz_app_question_change
/admin/quiz_app/question/<path:object_id>/delete/	django.contrib.admin.options.delete_view	admin:quiz_app_question_delete
/admin/quiz_app/question/<path:object_id>/history/	django.contrib.admin.options.history_view	admin:quiz_app_question_history
/admin/quiz_app/question/add/	django.contrib.admin.options.add_view	admin:quiz_app_question_add
/admin/quiz_app/quizsession/	django.contrib.admin.options.changelist_view	admin:quiz_app_quizsession_changelist
/admin/quiz_app/quizsession/<path:object_id>/	django.views.generic.base.RedirectView
/admin/quiz_app/quizsession/<path:object_id>/change/	django.contrib.admin.options.change_view	admin:quiz_app_quizsession_change
/admin/quiz_app/quizsession/<path:object_id>/delete/	django.contrib.admin.options.delete_view	admin:quiz_app_quizsession_delete
/admin/quiz_app/quizsession/<path:object_id>/history/	django.contrib.admin.options.history_view	admin:quiz_app_quizsession_history
/admin/quiz_app/quizsession/add/	django.contrib.admin.options.add_view	admin:quiz_app_quizsession_add
/admin/r/<int:content_type_id>/<path:object_id>/	django.contrib.contenttypes.views.shortcut	admin:view_on_site
/admin/users/passwordresettoken/	django.contrib.admin.options.changelist_view	admin:users_passwordresettoken_changelist
/admin/users/passwordresettoken/<path:object_id>/	django.views.generic.base.RedirectView
/admin/users/passwordresettoken/<path:object_id>/change/	django.contrib.admin.options.change_view	admin:users_passwordresettoken_change
/admin/users/passwordresettoken/<path:object_id>/delete/	django.contrib.admin.options.delete_view	admin:users_passwordresettoken_delete
/admin/users/passwordresettoken/<path:object_id>/history/	django.contrib.admin.options.history_view	admin:users_passwordresettoken_history
/admin/users/passwordresettoken/add/	django.contrib.admin.options.add_view	admin:users_passwordresettoken_add
/admin/users/user/	django.contrib.admin.options.changelist_view	admin:users_user_changelist
/admin/users/user/<id>/password/	django.contrib.auth.admin.user_change_password	admin:auth_user_password_change
/admin/users/user/<path:object_id>/	django.views.generic.base.RedirectView
/admin/users/user/<path:object_id>/change/	django.contrib.admin.options.change_view	admin:users_user_change
/admin/users/user/<path:object_id>/delete/	django.contrib.admin.options.delete_view	admin:users_user_delete
/admin/users/user/<path:object_id>/history/	django.contrib.admin.options.history_view	admin:users_user_history
/admin/users/user/add/	django.contrib.auth.admin.add_view	admin:users_user_add
/admin/users/userprofile/	django.contrib.admin.options.changelist_view	admin:users_userprofile_changelist
/admin/users/userprofile/<path:object_id>/	django.views.generic.base.RedirectView
/admin/users/userprofile/<path:object_id>/change/	django.contrib.admin.options.change_view	admin:users_userprofile_change
/admin/users/userprofile/<path:object_id>/delete/	django.contrib.admin.options.delete_view	admin:users_userprofile_delete
/admin/users/userprofile/<path:object_id>/history/	django.contrib.admin.options.history_view	admin:users_userprofile_history
/admin/users/userprofile/add/	django.contrib.admin.options.add_view	admin:users_userprofile_add
/api/auth/	rest_framework.routers.APIRootView	api-root
/api/auth/\.<format>/	rest_framework.routers.APIRootView	api-root
/api/auth/jwt/create/	rest_framework_simplejwt.views.TokenObtainPairView	jwt-create
/api/auth/jwt/refresh/	rest_framework_simplejwt.views.TokenRefreshView	jwt-refresh
/api/auth/jwt/verify/	rest_framework_simplejwt.views.TokenVerifyView	jwt-verify
/api/auth/users/	djoser.views.UserViewSet	user-list
/api/auth/users/<id>/	djoser.views.UserViewSet	user-detail
/api/auth/users/<id>\.<format>/	djoser.views.UserViewSet	user-detail
/api/auth/users/activation/	djoser.views.UserViewSet	user-activation
/api/auth/users/activation\.<format>/	djoser.views.UserViewSet	user-activation
/api/auth/users/me/	djoser.views.UserViewSet	user-me
/api/auth/users/me\.<format>/	djoser.views.UserViewSet	user-me
/api/auth/users/resend_activation/	djoser.views.UserViewSet	user-resend-activation
/api/auth/users/resend_activation\.<format>/	djoser.views.UserViewSet	user-resend-activation
/api/auth/users/reset_email/	djoser.views.UserViewSet	user-reset-username
/api/auth/users/reset_email\.<format>/	djoser.views.UserViewSet	user-reset-username
/api/auth/users/reset_email_confirm/	djoser.views.UserViewSet	user-reset-username-confirm
/api/auth/users/reset_email_confirm\.<format>/	djoser.views.UserViewSet	user-reset-username-confirm
/api/auth/users/reset_password/	djoser.views.UserViewSet	user-reset-password
/api/auth/users/reset_password\.<format>/	djoser.views.UserViewSet	user-reset-password
/api/auth/users/reset_password_confirm/	djoser.views.UserViewSet	user-reset-password-confirm
/api/auth/users/reset_password_confirm\.<format>/	djoser.views.UserViewSet	user-reset-password-confirm
/api/auth/users/set_email/	djoser.views.UserViewSet	user-set-username
/api/auth/users/set_email\.<format>/	djoser.views.UserViewSet	user-set-username
/api/auth/users/set_password/	djoser.views.UserViewSet	user-set-password
/api/auth/users/set_password\.<format>/	djoser.views.UserViewSet	user-set-password
/api/auth/users\.<format>/	djoser.views.UserViewSet	user-list
/api/quiz/	quiz_app.views.history_view.quiz_api_root	quiz-root
/api/quiz/admin/questions/	quiz_app.views.admin_questions_view.list_questions	admin-list-questions
/api/quiz/admin/questions/<int:question_id>/	quiz_app.views.admin_questions_view.get_question_detail	admin-question-detail
/api/quiz/admin/questions/<int:question_id>/delete/	quiz_app.views.admin_questions_view.delete_question	admin-delete-question
/api/quiz/admin/questions/<int:question_id>/update/	quiz_app.views.admin_questions_view.update_question	admin-update-question
/api/quiz/admin/questions/stats/	quiz_app.views.admin_questions_view.question_stats	admin-question-stats
/api/quiz/answer/	quiz_app.views.answer_view.submit_answer	submit-answer
/api/quiz/cancel/<int:session_id>/	quiz_app.views.quiz_view.cancel_quiz	cancel-quiz
/api/quiz/details/<int:session_id>/	quiz_app.views.history_view.quiz_details	quiz-details
/api/quiz/end/<int:session_id>/	quiz_app.views.quiz_view.end_quiz	end-quiz
/api/quiz/history/	quiz_app.views.history_view.quiz_history	quiz-history
/api/quiz/leaderboard/global/	quiz_app.views.leaderboard_view.global_leaderboard	leaderboard-global
/api/quiz/leaderboard/me/	quiz_app.views.leaderboard_view.user_ranking	leaderboard-me
/api/quiz/leaderboard/stats/	quiz_app.views.leaderboard_view.leaderboard_stats	leaderboard-stats
/api/quiz/leaderboard/topic/	quiz_app.views.leaderboard_view.topic_leaderboard	leaderboard-topic
/api/quiz/question/<int:session_id>/	quiz_app.views.question_view.get_question	get-question
/api/quiz/questions/	quiz_app.views.question_view.questions_library	questions-library
/api/quiz/start/	quiz_app.views.quiz_view.start_quiz	start-quiz
/api/users/admin/dashboard/	users.views.admin_view.admin_dashboard	admin-dashboard
/api/users/admin/sessions/<int:session_id>/delete/	users.views.admin_view.delete_quiz_session	admin-delete-session
/api/users/admin/users/	users.views.admin_view.all_users	admin-users
/api/users/admin/users/<int:user_id>/delete/	users.views.admin_view.delete_user	admin-delete-user
/api/users/admin/users/<int:user_id>/quizzes/	users.views.admin_view.user_quiz_history	admin-user-quizzes
/api/users/admin/users/<int:user_id>/role/	users.views.admin_view.change_user_role	admin-change-role
/api/users/admin/users/<int:user_id>/toggle/	users.views.admin_view.toggle_user_status	admin-toggle-user
/api/users/admin/users/search/	users.views.admin_view.search_users	admin-search-users
/api/users/avatar/delete/	users.views.profile_view.delete_avatar	delete-avatar
/api/users/avatar/upload/	users.views.profile_view.upload_avatar	upload-avatar
/api/users/change-password/	users.views.profile_view.change_password	change-password
/api/users/delete/	users.views.profile_view.delete_my_account	delete-my-account
/api/users/me/	users.views.profile_view.get_current_user	current-user
/api/users/password-reset/confirm/	users.views.auth_view.reset_password_with_code	reset-password-confirm
/api/users/password-reset/request/	users.views.auth_view.request_password_reset	request-password-reset
/api/users/password-reset/verify/	users.views.auth_view.verify_reset_code	verify-reset-code
/api/users/settings/	users.views.profile_view.update_profile_settings	update-profile-settings
/api/users/update/	users.views.profile_view.update_profile	update-profile
/media/<path>	django.views.static.serve
